3 - - - - - - - 4
- - 2 - 6 - 1 - -
- 1 - 9 - 8 - 2 -
- - 5 - - - 6 - -
- 2 - - - - - 1 -
- - 9 - - - 8 - -
- 8 - 3 - 4 - 6 -
- - 4 - 1 - 9 - -
5 - - - - - - - 7

